ASIA (EX. NEAR EAST)         	1
EASTERN EUROPE                     	1
NORTHERN AFRICA                    	1
OCEANIA                            	1
WESTERN EUROPE                     	1
SUB-SAHARAN AFRICA                 	1
LATIN AMER. & CARIB    	1
LATIN AMER. & CARIB    	1
LATIN AMER. & CARIB    	1
C.W. OF IND. STATES 	1
LATIN AMER. & CARIB    	1
OCEANIA                            	1
WESTERN EUROPE                     	1
C.W. OF IND. STATES 	1
LATIN AMER. & CARIB    	1
NEAR EAST                          	1
ASIA (EX. NEAR EAST)         	1
LATIN AMER. & CARIB    	1
C.W. OF IND. STATES 	1
WESTERN EUROPE                     	1
LATIN AMER. & CARIB    	1
SUB-SAHARAN AFRICA                 	1
NORTHERN AMERICA                   	1
ASIA (EX. NEAR EAST)         	1
LATIN AMER. & CARIB    	1
EASTERN EUROPE                     	1
SUB-SAHARAN AFRICA                 	1
LATIN AMER. & CARIB    	1
LATIN AMER. & CARIB    	1
ASIA (EX. NEAR EAST)         	1
EASTERN EUROPE                     	1
SUB-SAHARAN AFRICA                 	1
ASIA (EX. NEAR EAST)         	1
SUB-SAHARAN AFRICA                 	1
ASIA (EX. NEAR EAST)         	1
SUB-SAHARAN AFRICA                 	1
NORTHERN AMERICA                   	1
SUB-SAHARAN AFRICA                 	1
LATIN AMER. & CARIB    	1
SUB-SAHARAN AFRICA                 	1
SUB-SAHARAN AFRICA                 	1
LATIN AMER. & CARIB    	1
ASIA (EX. NEAR EAST)         	1
LATIN AMER. & CARIB    	1
SUB-SAHARAN AFRICA                 	1
SUB-SAHARAN AFRICA                 	1
SUB-SAHARAN AFRICA                 	1
OCEANIA                            	1
LATIN AMER. & CARIB    	1
SUB-SAHARAN AFRICA                 	1
EASTERN EUROPE                     	1
LATIN AMER. & CARIB    	1
NEAR EAST                          	1
EASTERN EUROPE                     	1
WESTERN EUROPE                     	1
SUB-SAHARAN AFRICA                 	1
LATIN AMER. & CARIB    	1
LATIN AMER. & CARIB    	1
ASIA (EX. NEAR EAST)         	1
LATIN AMER. & CARIB    	1
NORTHERN AFRICA                    	1
LATIN AMER. & CARIB    	1
SUB-SAHARAN AFRICA                 	1
SUB-SAHARAN AFRICA                 	1
BALTICS                            	1
SUB-SAHARAN AFRICA                 	1
WESTERN EUROPE                     	1
OCEANIA                            	1
WESTERN EUROPE                     	1
WESTERN EUROPE                     	1
LATIN AMER. & CARIB    	1
OCEANIA                            	1
SUB-SAHARAN AFRICA                 	1
SUB-SAHARAN AFRICA                 	1
NEAR EAST                          	1
C.W. OF IND. STATES 	1
WESTERN EUROPE                     	1
SUB-SAHARAN AFRICA                 	1
WESTERN EUROPE                     	1
WESTERN EUROPE                     	1
NORTHERN AMERICA                   	1
LATIN AMER. & CARIB    	1
LATIN AMER. & CARIB    	1
OCEANIA                            	1
LATIN AMER. & CARIB    	1
WESTERN EUROPE                     	1
SUB-SAHARAN AFRICA                 	1
SUB-SAHARAN AFRICA                 	1
LATIN AMER. & CARIB    	1
LATIN AMER. & CARIB    	1
LATIN AMER. & CARIB    	1
ASIA (EX. NEAR EAST)         	1
EASTERN EUROPE                     	1
WESTERN EUROPE                     	1
ASIA (EX. NEAR EAST)         	1
ASIA (EX. NEAR EAST)         	1
ASIA (EX. NEAR EAST)         	1
NEAR EAST                          	1
WESTERN EUROPE                     	1
WESTERN EUROPE                     	1
NEAR EAST                          	1
WESTERN EUROPE                     	1
LATIN AMER. & CARIB    	1
ASIA (EX. NEAR EAST)         	1
WESTERN EUROPE                     	1
NEAR EAST                          	1
C.W. OF IND. STATES 	1
SUB-SAHARAN AFRICA                 	1
OCEANIA                            	1
ASIA (EX. NEAR EAST)         	1
ASIA (EX. NEAR EAST)         	1
NEAR EAST                          	1
C.W. OF IND. STATES 	1
ASIA (EX. NEAR EAST)         	1
BALTICS                            	1
NEAR EAST                          	1
SUB-SAHARAN AFRICA                 	1
SUB-SAHARAN AFRICA                 	1
NORTHERN AFRICA                    	1
WESTERN EUROPE                     	1
BALTICS                            	1
WESTERN EUROPE                     	1
ASIA (EX. NEAR EAST)         	1
EASTERN EUROPE                     	1
SUB-SAHARAN AFRICA                 	1
SUB-SAHARAN AFRICA                 	1
ASIA (EX. NEAR EAST)         	1
ASIA (EX. NEAR EAST)         	1
SUB-SAHARAN AFRICA                 	1
WESTERN EUROPE                     	1
OCEANIA                            	1
LATIN AMER. & CARIB    	1
SUB-SAHARAN AFRICA                 	1
SUB-SAHARAN AFRICA                 	1
SUB-SAHARAN AFRICA                 	1
LATIN AMER. & CARIB    	1
OCEANIA                            	1
C.W. OF IND. STATES 	1
WESTERN EUROPE                     	1
ASIA (EX. NEAR EAST)         	1
LATIN AMER. & CARIB    	1
NORTHERN AFRICA                    	1
SUB-SAHARAN AFRICA                 	1
SUB-SAHARAN AFRICA                 	1
OCEANIA                            	1
ASIA (EX. NEAR EAST)         	1
WESTERN EUROPE                     	1
LATIN AMER. & CARIB    	1
OCEANIA                            	1
OCEANIA                            	1
LATIN AMER. & CARIB    	1
SUB-SAHARAN AFRICA                 	1
SUB-SAHARAN AFRICA                 	1
OCEANIA                            	1
WESTERN EUROPE                     	1
NEAR EAST                          	1
ASIA (EX. NEAR EAST)         	1
OCEANIA                            	1
LATIN AMER. & CARIB    	1
OCEANIA                            	1
LATIN AMER. & CARIB    	1
LATIN AMER. & CARIB    	1
ASIA (EX. NEAR EAST)         	1
EASTERN EUROPE                     	1
WESTERN EUROPE                     	1
LATIN AMER. & CARIB    	1
NEAR EAST                          	1
SUB-SAHARAN AFRICA                 	1
EASTERN EUROPE                     	1
C.W. OF IND. STATES 	1
SUB-SAHARAN AFRICA                 	1
SUB-SAHARAN AFRICA                 	1
LATIN AMER. & CARIB    	1
LATIN AMER. & CARIB    	1
NORTHERN AMERICA                   	1
LATIN AMER. & CARIB    	1
OCEANIA                            	1
WESTERN EUROPE                     	1
SUB-SAHARAN AFRICA                 	1
NEAR EAST                          	1
SUB-SAHARAN AFRICA                 	1
EASTERN EUROPE                     	1
SUB-SAHARAN AFRICA                 	1
SUB-SAHARAN AFRICA                 	1
ASIA (EX. NEAR EAST)         	1
EASTERN EUROPE                     	1
EASTERN EUROPE                     	1
OCEANIA                            	1
SUB-SAHARAN AFRICA                 	1
SUB-SAHARAN AFRICA                 	1
WESTERN EUROPE                     	1
ASIA (EX. NEAR EAST)         	1
SUB-SAHARAN AFRICA                 	1
LATIN AMER. & CARIB    	1
SUB-SAHARAN AFRICA                 	1
WESTERN EUROPE                     	1
WESTERN EUROPE                     	1
NEAR EAST                          	1
ASIA (EX. NEAR EAST)         	1
C.W. OF IND. STATES 	1
SUB-SAHARAN AFRICA                 	1
ASIA (EX. NEAR EAST)         	1
SUB-SAHARAN AFRICA                 	1
OCEANIA                            	1
LATIN AMER. & CARIB    	1
NORTHERN AFRICA                    	1
NEAR EAST                          	1
C.W. OF IND. STATES 	1
LATIN AMER. & CARIB    	1
OCEANIA                            	1
SUB-SAHARAN AFRICA                 	1
C.W. OF IND. STATES 	1
NEAR EAST                          	1
WESTERN EUROPE                     	1
NORTHERN AMERICA                   	1
LATIN AMER. & CARIB    	1
C.W. OF IND. STATES 	1
OCEANIA                            	1
LATIN AMER. & CARIB    	1
ASIA (EX. NEAR EAST)         	1
LATIN AMER. & CARIB    	1
OCEANIA                            	1
NEAR EAST                          	1
NORTHERN AFRICA                    	1
NEAR EAST                          	1
SUB-SAHARAN AFRICA                 	1
SUB-SAHARAN AFRICA                 	1
